###############################
#        E             @@@    #
# # # # # # # #@# # # # # # # #
#              @@@@@@@@       #
# # # # # # # #@# # # # # # # #
#   @@@@@              E      #
#@# # # # # # #M# # # # # # # #
#                      @@@    #
# #@# # # # # #@#@# # # # # # #
#  @    @@@    @@@            #
# #@# # #@# # # # # # # # # # #
#         E        @@@@@@     #
###############################
